+-+-+-+-+-+-+-+-+-+-+-+-+-+-+-+-+-+-+-+-+
    |         |     |   |   |       |   |
+-+ +-+-+-+-+ + +-+ + + +-+ + +-+-+ +-+ +
| |     | |     |   | | |   |     |   | |
+ + +-+ + + +-+-+ + + + + +-+ +-+ +-+ + +
| | | | | | | |   | | | |       | | | | |
+ + + + + + + + +-+ + + +-+-+-+ + + + + +
|   | | |   | | |   | |     |   | |     |
+-+-+ + + + + + +-+-+ +-+-+ +-+-+ +-+ +-+
|   |     | |   |     |     |   |   |   |
+ +-+-+ +-+-+-+-+ +-+-+ +-+-+ + +-+ +-+ +
|       |   |   | |   |       |     |   |
+-+-+ +-+-+ + + + + +-+-+-+ + +-+-+-+ + +
|   | |       |   |   |   | | |     | | |
+-+ + + +-+-+-+-+-+-+ + + + + + +-+ + + +
|   | |       |   |     | | | |   |   | |
+ +-+ +-+ +-+ + +-+ + +-+ + + +-+ +-+-+ +
|     |   |   |     | |   | | |   |   | |
+ +-+-+ +-+ + +-+-+-+ +-+-+-+ + +-+-+ + +
|       |   |       |         |       |
+-+-+-+-+-+-+-+-+-+-+-+-+-+-+-+-+-+-+-+-+